.....#........#.....
.....#........#.....
........####........
....................
##...####..####...##
.....#........#.....
..#..#.##..##.#..#..
..#.....####.....#..
..#..#.##..##.#..#..
.....#........#.....
##...####..####...##
....................
........####........
.....#........#.....
.....#........#.....